3 7 10
0 1 1
**********
..******..
*......***
****.*..**
**...*...*
*#.*******
**********
----------
**********
*#***#**!*
*.***.****
*...*...**
*.*****.**
*........*
**********
----------
**********
*.***.**!*
*.***....*
*.********
*.......**
*......!**
**********

